,R.R,R.X,S.S,S.X,U.S,U.X,total
amikacin,1,0,3,5,3,3,15
capreomycin,1,0,1,0,2,1,5
ethambutol,9,4,2,13,1,8,37
ethionamide,3,2,0,4,0,4,13
isoniazid,6,2,3,5,0,2,18
kanamycin,5,0,2,4,1,4,16
levofloxacin,9,0,5,2,3,1,20
linezolid,1,0,0,2,0,0,3
moxifloxacin,8,0,3,0,2,1,14
rifampicin,15,3,4,2,1,0,25
streptomycin,4,0,4,0,0,0,8
